year,state,size,CO,DA,HC,VW,total,totalRate
2001,HI,17532,88,344,4,18,454,0.025896
2001,AK,15040,12,52,0,12,76,0.005053
2001,FL,598297,1430,873,1,268,2572,0.004299
2001,SC,79734,168,706,0,25,899,0.011275
2001,GA,146465,316,1039,0,118,1473,0.010057
2001,AL,90640,116,234,0,75,425,0.004689
2001,NC,170558,584,2982,0,170,3736,0.021905
2001,TN,121760,411,1011,1,148,1571,0.012902
2001,RI,14264,66,511,0,32,609,0.042695
2001,CT,55634,287,705,0,104,1096,0.019700
2001,MA,168700,1035,4037,0,146,5218,0.030931
2001,ME,16282,69,258,0,16,343,0.021066
2001,NH,20350,37,691,0,19,747,0.036708
2001,VT,10078,162,1231,0,9,1402,0.139115
2001,NY,422678,970,4545,0,297,5812,0.013750
2001,NJ,108652,438,627,2,161,1228,0.011302
2001,PA,177830,503,2519,0,126,3148,0.017702
2001,DE,26778,115,1059,0,9,1183,0.044178
2001,MD,102436,430,1723,1,52,2206,0.021535
2001,WV,38810,31,402,0,34,467,0.012033
2001,KY,121655,314,966,5,66,1351,0.011105
2001,OH,267336,731,4694,0,192,5617,0.021011
2001,MI,241097,693,2252,0,208,3153,0.013078
2001,WY,21848,36,77,0,29,142,0.006499
2001,MT,33797,34,1028,0,44,1106,0.032725
2001,ID,61512,63,220,0,30,313,0.005088
2001,WA,118490,368,1939,0,97,2404,0.020289
2001,DC,157884,380,1661,0,73,2114,0.013390
2001,TX,443936,808,2532,0,306,3646,0.008213
2001,CA,657401,2412,7996,4,316,10728,0.016319
2001,AZ,114763,572,1582,0,52,2206,0.019222
2001,NV,69480,222,209,0,14,445,0.006405
2001,UT,140968,123,10,0,61,194,0.001376
2001,CO,145247,430,1983,0,90,2503,0.017233
2001,NM,58725,267,548,0,68,883,0.015036
2001,OR,56993,110,867,0,43,1020,0.017897
2001,ND,31780,31,534,0,14,579,0.018219
2001,SD,17829,42,640,0,8,690,0.038701
2001,NE,36907,86,317,0,15,418,0.011326
2001,IA,72225,173,1413,0,107,1693,0.023441
2001,MS,44737,84,126,0,36,246,0.005499
2001,IN,184866,390,2143,0,270,2803,0.015162
2001,IL,249825,699,2979,1,286,3965,0.015871
2001,MN,98727,137,2838,0,64,3039,0.030782
2001,WI,132355,310,2436,2,89,2837,0.021435
2001,MO,155653,386,2453,0,94,2933,0.018843
2001,AR,76584,123,247,0,43,413,0.005393
2001,OK,71254,167,287,0,45,499,0.007003
2001,KS,68658,205,942,0,66,1213,0.017667
2001,LA,84573,448,217,0,56,721,0.008525
2001,VA,176989,249,1774,3,149,2175,0.012289
2002,HI,18696,147,378,1,18,544,0.029097
2002,AK,15843,14,59,0,12,85,0.005365
2002,FL,630092,1410,972,2,268,2652,0.004209
2002,SC,84401,167,772,1,25,965,0.011434
2002,GA,163655,389,1375,0,118,1882,0.011500
2002,AL,96233,195,225,0,75,495,0.005144
2002,NC,176763,665,3298,0,170,4133,0.023382
2002,TN,143276,521,954,2,148,1625,0.011342
2002,RI,14180,92,790,0,32,914,0.064457
2002,CT,57666,304,830,0,104,1238,0.021468
2002,MA,169596,1042,3845,1,146,5034,0.029682
2002,ME,17161,74,311,0,16,401,0.023367
2002,NH,21433,24,728,0,19,771,0.035973
2002,VT,10314,113,1176,0,9,1298,0.125848
2002,NY,442889,1010,4578,0,297,5885,0.013288
2002,NJ,112346,340,685,0,161,1186,0.010557
2002,PA,186337,396,2405,0,126,2927,0.015708
2002,DE,27886,118,898,0,9,1025,0.036757
2002,MD,106012,390,2207,0,52,2649,0.024988
2002,WV,40033,54,533,0,34,621,0.015512
2002,KY,128164,352,797,1,66,1216,0.009488
2002,OH,271680,786,4620,2,192,5600,0.020612
2002,MI,244799,743,3091,1,208,4043,0.016516
2002,WY,22868,45,34,0,29,108,0.004723
2002,MT,34990,72,1119,0,44,1235,0.035296
2002,ID,64235,59,274,0,30,363,0.005651
2002,WA,126228,394,2243,0,97,2734,0.021659
2002,DC,159283,288,1790,2,73,2153,0.013517
2002,TX,465703,837,2579,0,306,3722,0.007992
2002,CA,686448,2557,8365,1,316,11239,0.016373
2002,AZ,118209,515,1498,0,52,2065,0.017469
2002,NV,71908,247,243,0,14,504,0.007009
2002,UT,144374,140,1,0,61,202,0.001399
2002,CO,151889,431,2574,0,90,3095,0.020377
2002,NM,60914,236,394,0,68,698,0.011459
2002,OR,60433,143,1908,1,43,2095,0.034666
2002,ND,33692,72,772,0,14,858,0.025466
2002,SD,18773,67,493,0,8,568,0.030256
2002,NE,37439,73,369,0,15,457,0.012207
2002,IA,75588,124,1533,0,107,1764,0.023337
2002,MS,45012,72,203,1,36,312,0.006931
2002,IN,179566,375,2040,0,270,2685,0.014953
2002,IL,257793,636,3280,0,286,4202,0.016300
2002,MN,104333,228,3128,0,64,3420,0.032780
2002,WI,134992,242,2585,0,89,2916,0.021601
2002,MO,164267,458,2026,0,94,2578,0.015694
2002,AR,79700,143,345,0,43,531,0.006662
2002,OK,74845,127,552,0,45,724,0.009673
2002,KS,71049,252,889,0,66,1207,0.016988
2002,LA,86872,382,255,0,56,693,0.007977
2002,VA,184194,265,1640,2,149,2056,0.011162
2003,HI,19862,153,524,1,18,696,0.035042
2003,AK,16607,16,53,0,12,81,0.004877
2003,FL,662429,1489,1375,0,268,3132,0.004728
2003,SC,87794,146,580,1,25,752,0.008566
2003,GA,191150,345,1180,0,118,1643,0.008595
2003,AL,100654,186,277,0,75,538,0.005345
2003,NC,201634,684,3579,0,170,4433,0.021985
2003,TN,147547,527,1043,0,148,1718,0.011644
2003,RI,14791,55,820,0,32,907,0.061321
2003,CT,57798,260,526,0,104,890,0.015398
2003,MA,168457,1249,4300,1,146,5696,0.033813
2003,ME,17174,77,490,0,16,583,0.033947
2003,NH,21538,35,973,0,19,1027,0.047683
2003,VT,10967,133,879,0,9,1021,0.093097
2003,NY,457657,941,4942,0,297,6180,0.013504
2003,NJ,113845,409,761,0,161,1331,0.011691
2003,PA,188610,406,2702,0,126,3234,0.017146
2003,DE,28073,73,1006,1,9,1089,0.038792
2003,MD,109066,380,2071,1,52,2504,0.022959
2003,WV,40613,67,554,1,34,656,0.016152
2003,KY,132568,358,613,0,66,1037,0.007822
2003,OH,274555,797,4965,0,192,5954,0.021686
2003,MI,246961,684,2469,3,208,3364,0.013622
2003,WY,24998,39,58,0,29,126,0.005040
2003,MT,37186,60,792,0,44,896,0.024095
2003,ID,67852,62,185,0,30,277,0.004082
2003,WA,130567,343,2537,0,97,2977,0.022801
2003,DC,179674,300,1654,0,73,2027,0.011282
2003,TX,502991,759,2863,1,306,3929,0.007811
2003,CA,692264,2708,9632,3,316,12659,0.018286
2003,AZ,138503,494,1199,1,52,1746,0.012606
2003,NV,75899,309,217,0,14,540,0.007115
2003,UT,161282,89,0,0,61,150,0.000930
2003,CO,156939,409,3683,2,90,4184,0.026660
2003,NM,64889,201,510,0,68,779,0.012005
2003,OR,62031,166,1646,1,43,1856,0.029921
2003,ND,36525,55,904,0,14,973,0.026639
2003,SD,18659,35,720,0,8,763,0.040892
2003,NE,36556,89,417,0,15,521,0.014252
2003,IA,80504,162,1452,1,107,1722,0.021390
2003,MS,45003,94,191,0,36,321,0.007133
2003,IN,182228,370,1869,1,270,2510,0.013774
2003,IL,281556,569,5604,1,286,6460,0.022944
2003,MN,109043,229,3139,1,64,3433,0.031483
2003,WI,133979,224,2942,0,89,3255,0.024295
2003,MO,171479,393,2105,0,94,2592,0.015116
2003,AR,85108,142,474,0,43,659,0.007743
2003,OK,96642,141,601,0,45,787,0.008143
2003,KS,90547,220,1199,0,66,1485,0.016400
2003,LA,88169,361,376,0,56,793,0.008994
2003,VA,209135,353,2137,2,149,2641,0.012628
2004,HI,20549,97,460,1,18,576,0.028031
2004,AK,16261,10,85,0,12,107,0.006580
2004,FL,693472,1247,1809,0,268,3324,0.004793
2004,SC,90658,161,1794,1,25,1981,0.021851
2004,GA,214192,291,1883,0,118,2292,0.010701
2004,AL,105762,242,270,0,75,587,0.005550
2004,NC,208898,552,4558,0,170,5280,0.025275
2004,TN,152087,471,1194,0,148,1813,0.011921
2004,RI,14749,84,1055,0,32,1171,0.079395
2004,CT,58632,249,797,1,104,1151,0.019631
2004,MA,168895,1122,4125,3,146,5396,0.031949
2004,ME,17710,121,448,0,16,585,0.033032
2004,NH,20722,52,1025,0,19,1096,0.052891
2004,VT,10940,90,566,0,9,665,0.060786
2004,NY,462057,1023,5877,1,297,7198,0.015578
2004,NJ,113869,390,1170,1,161,1722,0.015123
2004,PA,189765,447,2901,0,126,3474,0.018307
2004,DE,28364,80,1048,0,9,1137,0.040086
2004,MD,130490,289,2519,2,52,2862,0.021933
2004,WV,39175,94,742,0,34,870,0.022208
2004,KY,133422,314,489,0,66,869,0.006513
2004,OH,276835,889,4688,0,192,5769,0.020839
2004,MI,246897,682,2239,1,208,3130,0.012677
2004,WY,25755,35,67,0,29,131,0.005086
2004,MT,38019,38,896,0,44,978,0.025724
2004,ID,69061,60,243,0,30,333,0.004822
2004,WA,133434,287,2805,0,97,3189,0.023899
2004,DC,182790,293,1715,0,73,2081,0.011385
2004,TX,514105,883,2292,0,306,3481,0.006771
2004,CA,692685,2307,10293,0,316,12916,0.018646
2004,AZ,141317,526,1260,0,52,1838,0.013006
2004,NV,76916,251,244,0,14,509,0.006618
2004,UT,164660,96,130,0,61,287,0.001743
2004,CO,180619,523,2934,0,90,3547,0.019638
2004,NM,66119,161,533,0,68,762,0.011525
2004,OR,62893,303,2286,0,43,2632,0.041849
2004,ND,37761,75,1079,1,14,1169,0.030958
2004,SD,19004,30,644,0,8,682,0.035887
2004,NE,35616,102,562,0,15,679,0.019064
2004,IA,79089,146,1345,0,107,1598,0.020205
2004,MS,45684,47,229,0,36,312,0.006830
2004,IN,183114,513,2773,0,270,3556,0.019420
2004,IL,283632,645,4493,1,286,5425,0.019127
2004,MN,114621,182,3676,1,64,3923,0.034226
2004,WI,134091,275,3365,0,89,3729,0.027809
2004,MO,174514,443,2415,0,94,2952,0.016916
2004,AR,87723,186,651,0,43,880,0.010032
2004,OK,97486,120,646,0,45,811,0.008319
2004,KS,91708,218,1263,0,66,1547,0.016869
2004,LA,88625,352,514,0,56,922,0.010403
2004,VA,236607,384,2480,1,149,3014,0.012738
2005,HI,20644,86,852,0,18,956,0.046309
2005,AK,16412,16,83,0,12,111,0.006763
2005,FL,703719,1151,2164,2,268,3585,0.005094
2005,SC,92523,176,1697,0,25,1898,0.020514
2005,GA,222437,373,1663,0,118,2154,0.009684
2005,AL,113492,262,202,0,75,539,0.004749
2005,NC,214803,636,4336,1,170,5143,0.023943
2005,TN,153346,498,1441,0,148,2087,0.013610
2005,RI,15095,50,691,0,32,773,0.051209
2005,CT,59141,200,591,0,104,895,0.015133
2005,MA,183912,1276,4353,0,146,5775,0.031401
2005,ME,17621,65,489,0,16,570,0.032348
2005,NH,20697,38,893,0,19,950,0.045900
2005,VT,11597,89,715,0,9,813,0.070104
2005,NY,470872,1187,6002,0,297,7486,0.015898
2005,NJ,113730,386,1042,0,161,1589,0.013972
2005,PA,190586,527,2982,0,126,3635,0.019073
2005,DE,28893,66,1107,0,9,1182,0.040910
2005,MD,130091,274,2424,2,52,2752,0.021154
2005,WV,40039,102,961,0,34,1097,0.027398
2005,KY,132931,293,634,2,66,995,0.007485
2005,OH,276545,932,5294,1,192,6419,0.023211
2005,MI,246716,728,2237,1,208,3174,0.012865
2005,WY,26379,53,82,0,29,164,0.006217
2005,MT,38965,54,994,0,44,1092,0.028025
2005,ID,71138,59,96,0,30,185,0.002601
2005,WA,135271,311,2434,1,97,2843,0.021017
2005,DC,184248,309,2593,1,73,2976,0.016152
2005,TX,520640,834,1822,0,306,2962,0.005689
2005,CA,704513,2390,9298,0,316,12004,0.017039
2005,AZ,147050,478,1922,1,52,2453,0.016681
2005,NV,79021,252,259,0,14,525,0.006644
2005,UT,164857,130,224,0,61,415,0.002517
2005,CO,190553,516,2067,0,90,2673,0.014028
2005,NM,66649,191,511,0,68,770,0.011553
2005,OR,63500,255,2254,1,43,2553,0.040205
2005,ND,38306,45,957,0,14,1016,0.026523
2005,SD,19579,40,529,1,8,578,0.029521
2005,NE,35768,71,404,0,15,490,0.013699
2005,IA,87645,136,1508,0,107,1751,0.019978
2005,MS,46032,55,250,0,36,341,0.007408
2005,IN,184588,406,2469,1,270,3146,0.017043
2005,IL,286719,665,5648,0,286,6599,0.023016
2005,MN,116506,217,4060,0,64,4341,0.037260
2005,WI,136282,262,4038,0,89,4389,0.032205
2005,MO,178485,386,2422,0,94,2902,0.016259
2005,AR,90008,207,922,0,43,1172,0.013021
2005,OK,97717,166,581,0,45,792,0.008105
2005,KS,91354,200,1325,0,66,1591,0.017416
2005,LA,90302,392,145,0,56,593,0.006567
2005,VA,249250,409,2171,3,149,2732,0.010961
2006,HI,20357,46,722,2,18,788,0.038709
2006,AK,16163,25,66,0,12,103,0.006373
2006,FL,732516,1078,2617,0,268,3963,0.005410
2006,SC,95078,181,1056,0,25,1262,0.013273
2006,GA,228284,469,1800,0,118,2387,0.010456
2006,AL,117254,291,316,0,75,682,0.005816
2006,NC,221297,618,4589,10,170,5387,0.024343
2006,TN,156331,475,1590,0,148,2213,0.014156
2006,RI,15062,66,823,0,32,921,0.061147
2006,CT,59442,192,695,0,104,991,0.016672
2006,MA,187314,1277,3785,2,146,5210,0.027814
2006,ME,18102,62,613,0,16,691,0.038173
2006,NH,21116,45,803,0,19,867,0.041059
2006,VT,11870,90,1363,0,9,1462,0.123168
2006,NY,494649,1363,8056,0,297,9716,0.019642
2006,NJ,115280,373,1081,0,161,1615,0.014009
2006,PA,194834,576,3133,0,126,3835,0.019683
2006,DE,28585,99,830,0,9,938,0.032814
2006,MD,137588,412,2002,0,52,2466,0.017923
2006,WV,41051,39,948,0,34,1021,0.024872
2006,KY,134426,388,605,1,66,1060,0.007885
2006,OH,277590,1013,5667,0,192,6872,0.024756
2006,MI,245713,758,2628,1,208,3595,0.014631
2006,WY,26385,59,133,1,29,222,0.008414
2006,MT,39159,49,1530,0,44,1623,0.041446
2006,ID,70545,45,180,0,30,255,0.003615
2006,WA,136566,275,2681,0,97,3053,0.022355
2006,DC,203837,291,1601,1,73,1966,0.009645
2006,TX,529762,825,2290,0,306,3421,0.006458
2006,CA,723619,2454,11972,1,316,14743,0.020374
2006,AZ,151036,384,1420,1,52,1857,0.012295
2006,NV,79989,154,167,0,14,335,0.004188
2006,UT,165173,99,249,0,61,409,0.002476
2006,CO,192599,515,2484,0,90,3089,0.016039
2006,NM,66259,218,567,0,68,853,0.012874
2006,OR,63954,181,1814,0,43,2038,0.031867
2006,ND,38274,45,881,0,14,940,0.024560
2006,SD,20049,40,837,0,8,885,0.044142
2006,NE,36012,48,530,0,15,593,0.016467
2006,IA,95609,146,1655,0,107,1908,0.019956
2006,MS,46203,42,358,0,36,436,0.009437
2006,IN,186179,468,2728,1,270,3467,0.018622
2006,IL,288843,902,5027,1,286,6216,0.021520
2006,MN,119990,441,4458,1,64,4964,0.041370
2006,WI,139321,363,4091,0,89,4543,0.032608
2006,MO,180510,459,2518,0,94,3071,0.017013
2006,AR,92293,221,797,0,43,1061,0.011496
2006,OK,97155,138,811,0,45,994,0.010231
2006,KS,91963,227,1479,0,66,1772,0.019269
2006,LA,82773,384,64,1,56,505,0.006101
2006,VA,261062,507,2297,0,149,2953,0.011311
2007,HI,20051,62,730,0,18,810,0.040397
2007,AK,16463,12,52,0,12,76,0.004616
2007,FL,763600,978,2075,3,268,3324,0.004353
2007,SC,96952,203,1386,0,25,1614,0.016647
2007,GA,235214,380,1554,0,118,2052,0.008724
2007,AL,121615,317,573,1,75,966,0.007943
2007,NC,228925,584,3928,0,170,4682,0.020452
2007,TN,160158,396,1499,2,148,2045,0.012769
2007,RI,15650,44,834,0,32,910,0.058147
2007,CT,59182,201,751,0,104,1056,0.017843
2007,MA,190910,1062,5653,1,146,6862,0.035944
2007,ME,18351,58,581,0,16,655,0.035693
2007,NH,21444,33,892,0,19,944,0.044022
2007,VT,12239,72,1611,0,9,1692,0.138247
2007,NY,505679,1209,7168,0,297,8674,0.017153
2007,NJ,120732,275,1220,0,161,1656,0.013716
2007,PA,197663,611,2408,0,126,3145,0.015911
2007,DE,28695,57,814,0,9,880,0.030667
2007,MD,139433,289,2101,1,52,2443,0.017521
2007,WV,41921,73,968,0,34,1075,0.025643
2007,KY,150159,351,652,0,66,1069,0.007119
2007,OH,296194,987,5424,0,195,6606,0.022303
2007,MI,247980,660,2208,1,208,3077,0.012408
2007,WY,26134,29,43,0,29,101,0.003865
2007,MT,38819,29,1214,0,44,1287,0.033154
2007,ID,71467,56,326,0,30,412,0.005765
2007,WA,138599,247,2870,0,97,3214,0.023189
2007,DC,208459,313,2161,1,73,2548,0.012223
2007,TX,540037,827,2794,1,306,3928,0.007274
2007,CA,765395,2287,12160,2,316,14765,0.019291
2007,AZ,156117,368,1856,2,52,2278,0.014592
2007,NV,82399,165,114,0,14,293,0.003556
2007,UT,164624,101,188,0,61,350,0.002126
2007,CO,196170,394,4412,1,90,4897,0.024963
2007,NM,66482,267,629,0,68,964,0.014500
2007,OR,65033,164,2289,0,43,2496,0.038381
2007,ND,38345,26,577,0,14,617,0.016091
2007,SD,20888,33,680,0,8,721,0.034517
2007,NE,37129,32,557,0,15,604,0.016268
2007,IA,111271,143,1723,0,107,1973,0.017731
2007,MS,46760,71,186,0,36,293,0.006266
2007,IN,188952,484,3477,0,270,4231,0.022392
2007,IL,292227,741,4112,1,286,5140,0.017589
2007,MN,126279,441,3741,0,64,4246,0.033624
2007,WI,141421,381,3010,1,89,3481,0.024614
2007,MO,183429,336,2355,0,94,2785,0.015183
2007,AR,94665,213,461,0,43,717,0.007574
2007,OK,97433,131,527,0,45,703,0.007215
2007,KS,95113,178,1322,0,66,1566,0.016465
2007,LA,80406,386,146,0,56,588,0.007313
2007,VA,278216,491,2045,0,149,2685,0.009651
2008,HI,35394,63,347,0,18,428,0.012092
2008,AK,31874,7,39,0,12,58,0.001820
2008,FL,815591,1050,2413,0,268,3731,0.004575
2008,SC,112551,196,1279,0,25,1500,0.013327
2008,GA,254872,377,1887,0,118,2382,0.009346
2008,AL,139366,253,552,0,75,880,0.006314
2008,NC,250522,586,3365,0,170,4121,0.016450
2008,TN,177078,339,1379,0,148,1866,0.010538
2008,RI,15904,51,686,0,32,769,0.048353
2008,CT,73692,200,824,1,104,1129,0.015321
2008,MA,194937,874,5105,1,146,6126,0.031426
2008,ME,18809,67,581,0,16,664,0.035302
2008,NH,21889,31,925,0,19,975,0.044543
2008,VT,12800,84,1841,0,9,1934,0.151094
2008,NY,518645,1323,7257,0,297,8877,0.017116
2008,NJ,149402,353,1832,0,161,2346,0.015703
2008,PA,202180,580,1992,1,126,2699,0.013349
2008,DE,29633,70,804,0,9,883,0.029798
2008,MD,158688,304,2013,0,52,2369,0.014929
2008,WV,42413,74,1262,0,34,1370,0.032301
2008,KY,166410,356,746,0,66,1168,0.007019
2008,OH,318538,786,5101,1,195,6083,0.019097
2008,MI,248236,690,2850,1,208,3749,0.015103
2008,WY,24524,44,62,0,29,135,0.005505
2008,MT,38640,33,1232,0,44,1309,0.033877
2008,ID,86069,33,271,0,30,334,0.003881
2008,WA,155916,248,2568,3,97,2916,0.018702
2008,DC,208114,330,1199,1,73,1603,0.007703
2008,TX,568233,711,2608,1,306,3626,0.006381
2008,CA,794395,2180,10950,3,316,13449,0.016930
2008,AZ,196502,364,1566,2,52,1984,0.010097
2008,NV,101002,123,193,0,14,330,0.003267
2008,UT,186555,145,204,0,61,410,0.002198
2008,CO,214945,325,4665,0,90,5080,0.023634
2008,NM,81640,213,572,0,68,853,0.010448
2008,OR,83364,153,2375,0,43,2571,0.030841
2008,ND,53660,39,486,0,14,539,0.010045
2008,SD,21286,41,753,0,8,802,0.037677
2008,NE,53011,22,606,0,15,643,0.012130
2008,IA,139764,133,1833,0,107,2073,0.014832
2008,MS,63131,68,201,0,36,305,0.004831
2008,IN,209113,436,3033,1,270,3740,0.017885
2008,IL,309065,744,4377,0,286,5407,0.017495
2008,MN,105520,292,3064,0,64,3420,0.032411
2008,WI,141869,207,4132,0,89,4428,0.031212
2008,MO,186831,348,2174,1,94,2617,0.014007
2008,AR,109951,211,868,0,43,1122,0.010205
2008,OK,125776,127,801,0,45,973,0.007736
2008,KS,111776,184,1449,0,66,1699,0.015200
2008,LA,97224,339,430,0,56,825,0.008486
2008,VA,301879,407,2013,0,149,2569,0.008510
2009,HI,35684,82,808,0,18,908,0.025446
2009,AK,32525,15,55,0,12,82,0.002521
2009,FL,857098,963,3041,10,268,4282,0.004996
2009,SC,134511,191,1119,0,25,1335,0.009925
2009,GA,269032,376,2370,12,127,2885,0.010724
2009,AL,158151,202,768,0,75,1045,0.006608
2009,NC,260271,447,3932,0,170,4549,0.017478
2009,TN,182430,346,1221,2,148,1717,0.009412
2009,RI,16389,40,727,14,32,813,0.049606
2009,CT,76147,170,689,12,104,975,0.012804
2009,MA,201899,523,4981,20,146,5670,0.028083
2009,ME,19013,51,506,0,16,573,0.030137
2009,NH,22372,29,823,0,19,871,0.038933
2009,VT,13391,55,1911,0,9,1975,0.147487
2009,NY,567063,854,7928,30,297,9109,0.016063
2009,NJ,155860,237,1896,44,161,2338,0.015001
2009,PA,207533,320,2448,40,126,2934,0.014138
2009,DE,30788,50,1010,0,9,1069,0.034721
2009,MD,163593,192,1958,34,52,2236,0.013668
2009,WV,42674,55,1314,0,34,1403,0.032877
2009,KY,168528,396,585,10,66,1057,0.006272
2009,OH,329571,811,6058,10,195,7074,0.021464
2009,MI,252438,483,2691,8,208,3390,0.013429
2009,WY,25202,31,106,0,29,166,0.006587
2009,MT,40044,25,1248,0,44,1317,0.032889
2009,ID,87351,33,348,6,30,417,0.004774
2009,WA,166866,219,2771,6,97,3093,0.018536
2009,DC,212461,300,1245,38,73,1656,0.007794
2009,TX,603782,705,2635,6,306,3652,0.006049
2009,CA,845289,1669,9960,50,316,11995,0.014190
2009,AZ,212029,336,1613,8,52,2009,0.009475
2009,NV,103312,116,215,2,14,347,0.003359
2009,UT,193744,104,200,0,61,365,0.001884
2009,CO,222057,252,5183,12,90,5537,0.024935
2009,NM,84682,195,912,0,68,1175,0.013875
2009,OR,87435,142,2160,0,43,2345,0.026820
2009,ND,55385,35,905,0,14,954,0.017225
2009,SD,21993,61,633,0,8,702,0.031919
2009,NE,53969,17,653,0,15,685,0.012692
2009,IA,188081,117,1860,6,107,2090,0.011112
2009,MS,76546,94,158,0,36,288,0.003762
2009,IN,215749,352,2392,52,270,3066,0.014211
2009,IL,314448,555,5390,26,286,6257,0.019898
2009,MN,139250,210,2822,16,64,3112,0.022348
2009,WI,145927,247,5115,4,89,5455,0.037382
2009,MO,192936,313,2805,6,94,3218,0.016679
2009,AR,113128,190,614,0,43,847,0.007487
2009,OK,127958,164,725,0,45,934,0.007299
2009,KS,113353,132,1414,0,66,1612,0.014221
2009,LA,98132,240,452,2,56,750,0.007643
2009,VA,322739,406,1933,10,149,2498,0.007740
2010,HI,35825,113,762,0,18,893,0.024927
2010,AK,33642,5,78,0,12,95,0.002824
2010,FL,902436,954,2965,8,268,4195,0.004649
2010,SC,137162,209,1801,8,25,2043,0.014895
2010,GA,275471,359,2862,6,127,3354,0.012176
2010,AL,165890,207,1133,0,75,1415,0.008530
2010,NC,260510,485,4043,8,170,4706,0.018065
2010,TN,186710,355,1297,18,148,1818,0.009737
2010,RI,16294,36,620,22,32,710,0.043574
2010,CT,77128,122,1379,12,104,1617,0.020965
2010,MA,206702,424,4951,24,146,5545,0.026826
2010,ME,19535,31,631,0,16,678,0.034707
2010,NH,23129,37,965,0,19,1021,0.044144
2010,VT,13554,58,1775,0,9,1842,0.135901
2010,NY,535761,796,7600,64,297,8757,0.016345
2010,NJ,160949,282,2397,42,161,2882,0.017906
2010,PA,211628,343,3265,48,126,3782,0.017871
2010,DE,31278,29,1100,0,9,1138,0.036383
2010,MD,167753,199,1977,44,52,2272,0.013544
2010,WV,43498,44,1633,0,34,1711,0.039335
2010,KY,181981,289,925,10,66,1290,0.007089
2010,OH,340799,822,6884,18,195,7919,0.023237
2010,MI,255291,422,2722,28,208,3380,0.013240
2010,WY,24933,61,109,2,29,201,0.008062
2010,MT,40745,36,1347,0,44,1427,0.035023
2010,ID,87280,46,380,2,30,458,0.005247
2010,WA,166033,210,2457,0,97,2764,0.016647
2010,DC,215255,210,1462,12,73,1757,0.008162
2010,TX,627985,701,2695,12,306,3714,0.005914
2010,CA,851797,1657,12265,130,316,14368,0.016868
2010,AZ,219015,280,2623,20,52,2975,0.013584
2010,NV,104118,117,160,6,14,297,0.002853
2010,UT,201664,87,249,2,61,399,0.001979
2010,CO,225639,240,5154,14,90,5498,0.024366
2010,NM,85736,195,484,0,68,747,0.008713
2010,OR,90618,171,1967,4,43,2185,0.024112
2010,ND,56111,29,1155,0,14,1198,0.021351
2010,SD,22967,49,724,2,8,783,0.034092
2010,NE,54763,22,578,6,15,621,0.011340
2010,IA,212463,114,1658,2,107,1881,0.008853
2010,MS,80139,144,144,0,36,324,0.004043
2010,IN,221890,357,2524,48,270,3199,0.014417
2010,IL,317245,460,6796,18,286,7560,0.023830
2010,MN,195263,170,3019,26,64,3279,0.016793
2010,WI,148653,194,4622,18,89,4923,0.033117
2010,MO,198447,274,2787,8,94,3163,0.015939
2010,AR,116107,144,791,4,43,982,0.008458
2010,OK,131058,104,1014,6,45,1169,0.008920
2010,KS,113575,127,1382,2,66,1577,0.013885
2010,LA,100927,169,390,4,56,619,0.006133
2010,VA,333584,407,2040,0,149,2596,0.007782
2011,HI,35749,110,1110,0,18,1238,0.034630
2011,AK,33448,10,78,0,12,100,0.002990
2011,FL,973498,721,3495,14,268,4498,0.004620
2011,SC,153004,208,2409,14,25,2656,0.017359
2011,GA,295492,337,2383,2,127,2849,0.009642
2011,AL,166502,199,1261,0,75,1535,0.009219
2011,NC,258408,437,5128,6,170,5741,0.022217
2011,TN,187829,263,1903,14,148,2328,0.012394
2011,RI,16317,75,769,2,32,878,0.053809
2011,CT,77117,158,1429,6,104,1697,0.022006
2011,MA,205524,361,4729,30,146,5266,0.025622
2011,ME,23019,24,685,0,16,725,0.031496
2011,NH,26979,48,886,0,19,953,0.035324
2011,VT,13478,46,1678,4,9,1737,0.128877
2011,NY,576360,678,7828,54,297,8857,0.015367
2011,NJ,190580,276,2350,28,161,2815,0.014771
2011,PA,213573,408,3225,40,126,3799,0.017788
2011,DE,32337,42,953,0,9,1004,0.031048
2011,MD,170547,162,2244,24,52,2482,0.014553
2011,WV,43583,46,2013,8,34,2101,0.048207
2011,KY,184080,212,1269,14,66,1561,0.008480
2011,OH,342952,579,7030,28,195,7832,0.022837
2011,MI,256606,355,5094,32,208,5689,0.022170
2011,WY,24684,20,98,2,29,149,0.006036
2011,MT,41099,51,1404,2,44,1501,0.036522
2011,ID,89583,64,785,6,30,885,0.009879
2011,WA,167387,182,2906,12,97,3197,0.019099
2011,DC,217059,216,1120,16,73,1425,0.006565
2011,TX,643277,694,2818,12,306,3830,0.005954
2011,CA,906067,1583,12199,58,317,14157,0.015625
2011,AZ,223639,299,2959,12,52,3322,0.014854
2011,NV,98405,105,269,0,14,388,0.003943
2011,UT,215608,160,364,6,61,591,0.002741
2011,CO,223134,308,6035,12,90,6445,0.028884
2011,NM,85062,193,494,2,68,757,0.008899
2011,OR,93262,162,1740,4,43,1949,0.020898
2011,ND,56175,25,840,0,14,879,0.015648
2011,SD,22695,42,607,4,8,661,0.029125
2011,NE,54625,33,401,0,15,449,0.008220
2011,IA,203791,128,1962,4,107,2201,0.010800
2011,MS,83417,125,128,0,36,289,0.003465
2011,IN,222447,455,3634,26,270,4385,0.019713
2011,IL,330938,513,7436,24,286,8259,0.024956
2011,MN,193539,137,2681,10,64,2892,0.014943
2011,WI,158433,181,4722,2,89,4994,0.031521
2011,MO,201659,248,2906,12,94,3260,0.016166
2011,AR,118097,164,696,6,43,909,0.007697
2011,OK,133161,137,1061,8,45,1251,0.009395
2011,KS,114057,126,1732,0,66,1924,0.016869
2011,LA,101689,206,721,2,56,985,0.009686
2011,VA,352812,289,3549,2,150,3990,0.011309
2012,HI,35988,113,1088,0,18,1219,0.033872
2012,AK,33059,8,107,4,12,131,0.003963
2012,FL,984950,746,3508,26,268,4548,0.004617
2012,SC,153218,128,1572,2,25,1727,0.011272
2012,GA,3.076165e+05,311,1888,8,135,2342,0.007613
2012,AL,167151,195,1775,4,75,2049,0.012258
2012,NC,257888,419,4611,2,170,5202,0.020172
2012,TN,184718,306,1976,10,148,2440,0.013209
2012,RI,16451,88,852,0,32,972,0.059085
2012,CT,76159,188,1451,10,104,1753,0.023018
2012,MA,208661,360,3766,18,146,4290,0.020560
2012,ME,28355,25,722,0,16,763,0.026909
2012,NH,32721,47,936,0,19,1002,0.030623
2012,VT,13098,48,1647,6,9,1710,0.130554
2012,NY,580935,573,8073,94,297,9037,0.015556
2012,NJ,194017,257,1987,32,161,2437,0.012561
2012,PA,215089,395,3302,12,126,3835,0.017830
2012,DE,34437,26,942,0,9,977,0.028371
2012,MD,263153,134,1801,30,52,2017,0.007665
2012,WV,43415,51,2753,0,34,2838,0.065369
2012,KY,184181,277,1257,6,66,1606,0.008720
2012,OH,340651,525,6683,18,195,7421,0.021785
2012,MI,255816,438,5126,22,208,5794,0.022649
2012,WY,24668,30,90,0,29,149,0.006040
2012,MT,40980,65,851,2,44,962,0.023475
2012,ID,99204,53,778,0,30,861,0.008679
2012,WA,168493,194,3088,18,97,3397,0.020161
2012,DC,236308,224,1265,12,73,1574,0.006661
2012,TX,651794,744,3236,26,306,4312,0.006616
2012,CA,974414,1475,11557,60,317,13409,0.013761
2012,AZ,234025,385,3005,8,52,3450,0.014742
2012,NV,96856,84,375,0,14,473,0.004884
2012,UT,217290,155,323,2,61,541,0.002490
2012,CO,218121,254,5466,10,90,5820,0.026682
2012,NM,84904,157,608,6,68,839,0.009882
2012,OR,94730,280,2064,6,43,2393,0.025261
2012,ND,57020,46,637,0,14,697,0.012224
2012,SD,22867,24,583,10,8,625,0.027332
2012,NE,54555,34,566,0,15,615,0.011273
2012,IA,199749,117,1431,4,107,1659,0.008305
2012,MS,84147,70,231,0,36,337,0.004005
2012,IN,269578,693,6143,28,270,7134,0.026464
2012,IL,358545,563,6846,28,286,7723,0.021540
2012,MN,191959,134,2802,8,64,3008,0.015670
2012,WI,206859,140,6071,6,89,6306,0.030485
2012,MO,251919,279,3033,6,94,3412,0.013544
2012,AR,119126,168,865,10,43,1086,0.009116
2012,OK,134039,82,612,0,45,739,0.005513
2012,KS,113557,150,1735,2,66,1953,0.017198
2012,LA,102328,180,604,14,56,854,0.008346
2012,VA,358185,294,3513,2,150,3959,0.011053
2013,HI,34570,119,972,0,18,1109,0.032080
2013,AK,31927,15,112,2,12,141,0.004416
2013,FL,969209,581,3001,14,268,3864,0.003987
2013,SC,152398,106,1583,0,25,1714,0.011247
2013,GA,305152,303,1952,12,135,2402,0.007871
2013,AL,165517,149,1768,2,75,1994,0.012047
2013,NC,256869,372,4286,18,170,4846,0.018866
2013,TN,179476,271,1803,10,148,2232,0.012436
2013,RI,16387,68,848,2,32,950,0.057973
2013,CT,75253,179,1246,8,104,1537,0.020424
2013,MA,201215,335,4063,24,146,4568,0.022702
2013,ME,39636,46,919,2,16,983,0.024801
2013,NH,43302,56,807,0,19,882,0.020369
2013,VT,12723,65,1895,2,9,1971,0.154916
2013,NY,582591,544,7812,66,297,8719,0.014966
2013,NJ,203203,242,1795,12,161,2210,0.010876
2013,PA,217129,337,3889,32,126,4384,0.020191
2013,DE,35787,29,907,0,9,945,0.026406
2013,MD,263367,136,1614,20,52,1822,0.006918
2013,WV,42873,41,2253,0,34,2328,0.054300
2013,KY,181828,244,1343,2,66,1655,0.009102
2013,OH,339329,460,5827,30,195,6512,0.019191
2013,MI,254859,426,5367,24,208,6025,0.023641
2013,WY,23756,35,75,2,29,141,0.005935
2013,MT,40355,37,767,4,44,852,0.021113
2013,ID,100565,68,652,0,30,750,0.007458
2013,WA,166740,249,2504,12,97,2862,0.017164
2013,DC,278175,208,1470,32,73,1783,0.006410
2013,TX,656658,695,3317,18,306,4336,0.006603
2013,CA,1053842,1365,10927,72,319,12683,0.012035
2013,AZ,231701,298,3919,10,52,4279,0.018468
2013,NV,121035,93,514,2,14,623,0.005147
2013,UT,253856,238,377,2,61,678,0.002671
2013,CO,213957,222,3930,12,90,4254,0.019882
2013,NM,81828,169,579,4,68,820,0.010021
2013,OR,95199,293,2070,0,43,2406,0.025273
2013,ND,55314,39,661,0,14,714,0.012908
2013,SD,22760,24,576,6,8,614,0.026977
2013,NE,54236,52,627,0,15,694,0.012796
2013,IA,185373,90,1588,14,107,1799,0.009705
2013,MS,82343,74,294,0,36,404,0.004906
2013,IN,275946,589,5436,22,270,6317,0.022892
2013,IL,358919,404,6827,12,286,7529,0.020977
2013,MN,190173,114,2986,8,64,3172,0.016680
2013,WI,209178,175,7225,6,89,7495,0.035831
2013,MO,254517,342,3081,10,94,3527,0.013858
2013,AR,117619,113,979,4,43,1139,0.009684
2013,OK,130977,98,857,12,45,1012,0.007727
2013,KS,111844,120,1759,4,66,1949,0.017426
2013,LA,100575,179,242,8,56,485,0.004822
2013,VA,397867,305,2906,8,150,3369,0.008468
2014,HI,108468,62,1351,0,18,1431,0.013193
2014,AK,31327,12,109,0,12,133,0.004246
2014,FL,955969,622,3890,12,268,4792,0.005013
2014,SC,151869,157,1884,0,25,2066,0.013604
2014,GA,382349,394,2470,2,135,3001,0.007849
2014,AL,167605,188,1773,2,75,2038,0.012160
2014,NC,337537,476,4420,6,170,5072,0.015027
2014,TN,176151,238,2126,4,148,2516,0.014283
2014,RI,16571,31,1229,34,32,1326,0.080019
2014,CT,75915,191,1673,2,104,1970,0.025950
2014,MA,201793,345,4149,30,146,4670,0.023143
2014,ME,54560,30,749,0,16,795,0.014571
2014,NH,58391,53,646,0,19,718,0.012296
2014,VT,12856,59,1011,2,9,1081,0.084085
2014,NY,666998,482,7616,58,297,8453,0.012673
2014,NJ,233921,240,1892,20,161,2313,0.009888
2014,PA,245128,354,4609,24,126,5113,0.020858
2014,DE,37147,49,794,0,9,852,0.022936
2014,MD,297423,199,2240,8,52,2499,0.008402
2014,WV,42556,47,1864,0,34,1945,0.045704
2014,KY,180588,214,2023,4,66,2307,0.012775
2014,OH,367276,467,6398,16,195,7076,0.019266
2014,MI,254691,484,5829,58,208,6579,0.025831
2014,WY,23612,32,45,2,29,108,0.004574
2014,MT,39726,43,953,4,44,1044,0.026280
2014,ID,108950,33,802,2,30,867,0.007958
2014,WA,236490,180,2771,12,97,3060,0.012939
2014,DC,330176,191,1309,18,73,1591,0.004819
2014,TX,721386,674,3402,18,306,4400,0.006099
2014,CA,1132578,1316,9345,58,319,11038,0.009746
2014,AZ,243807,255,3764,18,52,4089,0.016771
2014,NV,140324,85,521,0,14,620,0.004418
2014,UT,263072,189,488,16,61,754,0.002866
2014,CO,210424,220,4451,6,90,4767,0.022654
2014,NM,79913,152,532,8,68,760,0.009510
2014,OR,94854,211,2128,4,43,2386,0.025154
2014,ND,81500,27,405,0,14,446,0.005472
2014,SD,22604,14,790,4,8,816,0.036100
2014,NE,54409,33,600,4,15,652,0.011983
2014,IA,179588,149,1456,8,107,1720,0.009577
2014,MS,84212,115,237,2,36,390,0.004631
2014,IN,276431,565,8323,20,270,9178,0.033202
2014,IL,357721,406,7065,10,286,7767,0.021712
2014,MN,191092,135,3046,4,64,3249,0.017002
2014,WI,211002,216,7811,20,89,8136,0.038559
2014,MO,255622,273,3215,18,94,3600,0.014083
2014,AR,116463,116,1161,2,43,1322,0.011351
2014,OK,128367,96,943,4,45,1088,0.008476
2014,KS,138590,120,1576,4,66,1766,0.012743
2014,LA,127609,208,258,4,56,526,0.004122
2014,VA,435236,280,3654,6,150,4090,0.009397
